#Snowdonian rails
3 4 408 1122 227 1700 
1 16 1768 393 859 412 1072 734 1979 1465 2310 1222 1809 151 3372 2806 1168 1700 
1 3 2806 2665 227 
2 5 1132 1768 3134 1567 1999 
2 5 137 1387 1862 877 1999 
1 9 453 2181 2407 1907 1170 3049 1027 2018 3347 
1 8 2323 2785 1010 2949 1409 2989 2537 137
#Highland rails
1 9 1911 1545 862 198 2783 1068 1627 1600 204
1 8 2926 2055 3304 160 2696 1123 1724 2027
1 3 1724 3307 1512
2 5 2027 1512 2402 2798 1295
2 8 2027 737 2295 2593 2456 2839 401 2871
1 2 2593 2298
1 10 2456 2298 1716 1841 2088 2370 1256 143 2770 1665 