3 4 408 1122 227 1700 
1 16 1768 393 859 412 1072 734 1979 1465 2310 1222 1809 151 3372 2806 1168 1700 
1 3 2806 2665 227 
2 5 1132 1768 3134 1567 1999 
2 5 137 1387 1862 877 1999 
1 9 453 2181 2407 1907 1170 3049 1027 2018 3347 
1 9 1911 1545 862 198 2783 1068 1627 1600 204 
1 8 2926 2055 3304 160 2696 1123 1724 2027 
1 3 1724 3307 1512 
2 5 2027 1512 2402 2798 1295 
2 8 2027 737 2295 2593 2456 2839 401 2871 
1 2 2593 2298 
1 10 2456 2298 1716 1841 2088 2370 1256 143 2770 1665 
2 9 1512 1182 1992 2425 2992 1374 3269 141 1816 
2 3 3269 2400 697 
5 3 1725 1816 1400 
4 7 1400 2387 2977 697 1826 2033 1738 
2 11 1400 3042 1479 1383 364 1411 176 3237 1445 1499 941 
1 5 1725 2987 389 1338 4 
1 7 1911 1067 2934 665 1788 1939 2926 
1 4 665 708 2621 757 
1 3 3304 774 1610 
1 6 176 586 1683 929 1023 2633 
2 4 3042 2810 455 2814 
1 11 2814 2556 1510 700 2502 1870 2499 3212 840 1285 3210 
1 6 3289 3283 1840 352 1037 2425 
2 12 920 1190 434 1105 2168 17 1936 2767 1705 221 2980 34 
2 4 2980 1273 3226 1775 
1 9 1775 179 2213 2301 8 2253 175 1164 3214 
1 4 434 838 2292 1407 
1 11 453 2440 907 1213 2823 55 275 1140 2834 3310 2323 
1 2 635 1213 
1 5 2229 2642 952 1523 2785 
1 2 1523 2834 
1 4 163 1629 527 1126 
5 4 34 890 2368 163 
5 2 890 163 
4 8 34 1171 2105 2683 3255 1927 1619 1770 
2 9 2368 1090 3064 994 2101 926 885 2537 137 
1 7 2323 2785 1010 2949 1409 2989 2537 
2 4 2683 1648 1166 2368 
1 7 1802 1709 1692 3082 1983 2419 885 
